222222222222222212222222222222222
244444444444444411555555555555552
244444444444444411555555555555552
244444444444444411555555555555552
244444444444444244255555555555552
244444444444422444422555555555552
288444444444244444444255555555552
255884444444244444444255555558882
255558844442444444444425555884442
255555588442444444444425588444442
255555555882244277244228844444442
255555555552522277222524444444442
255555555555255555555244444444442
255555555555255555555244444444442
255555555555522555522444444444442
255555555555555255244444444444442
255555555555555511444444444444442
255555555555555511444444444444442
255555555555555511444444444444442
255555555555555511444444444444442
255555555555555511444444444444442
255555555555555511444444444444442
255555555555555511444444444444442
222222222222222288222222222222222