6666666666666666666666666666666666
6666666666666666666666666666666666
6666666666660666666666666666666666
6666666666600066666666666666666666
6666666666000006666666666666666666
6666666660009000666666666666666666
6666666666669999999999966666666666
6666666666666666666666999966666666
6666699999999999999999999966666666
6666696666669666666666999966666666
6666696666666666666666666666666666
6666696666666666666666666666666666
6666696666666666666666666666666666
6669999666669666666666666666666666
6669999999999999999996666666666666
6669999666669666666696666666666666
6666666666666666666696666666666666
6666666666666666666696666666666666
6666666666666666666999966666666666
6666666666669999999999966666666666
6666666666669666666999966666666666
6666666666669666666666666666666666
6666666666669666666666666666666666
6666666666669666666666666666666666