222222221222222222222222222222
233333331333330000220088888882
236666631333330444444080075082
236666631111111111111180047082
236666633333322222222100000082
236666666666632222222100000082
236666666663331111111188888882
236666666663233323333322222222
236666666663233323666322222222
236666666663233323666322222222
236666666663233323666663222222
236666666663231373333333333322
236666663333331111111113333022
236666632222222222224512222222
233333330000000000005412333332
200311111111111111111112333332
200313333333333332223323333332
200313366666666632223323333332
200313366666666632223333333332
200313333366666632233333333332
200311111366666632333333333332
200300051233333332333333333332
222222221222222222222222222222