2222222212222222222222222222222
2000000010000000000000000000002
2000000010000000000000000000002
2004500010000000000000000000002
2005400010000000000550000000002
2000004010000000000550000000002
2000000013330000000000000000002
2000000013330000000000000000002
2000000013330000000000000000002
2333333313332222222220000000002
2366666611111111111120000000002
2366666612000022222220000000002
2366666610000000000003330000002
2366666610000000000003330000002
2333333310000040000000000000002
2000000010000000000000000000002
2000000010000000000000000000002
2000000010000000000000000000002
2000000010000050000000000000002
2222222222222222222222222222222